wwwwwwwwwwwwwwwwwwwwwwwwwwwwwwwwwwww
w...........k......................w
w..........sw.........o.wwww.......w
w.........ss..........ww....sw.....w
w........ss................ww......w
w.......ss................ww.......w
w......ss....s...........ww........w
w.....ms.....s.....m....ww.........w
w....wwwwwwwwsww..www..ww..........w
w............s........wwwwwwww.....w
w............s....................iw
wwwwwwwwwwwwwwwwwwwwwwwwwwwwwwwwwwww
