wwwwwwwwwwwwwwwww
w...............w
w...............w
w...............w
w..........g..M.w
wwwswwwwwwwwwwwww
w..s.m..........w
wi.s.s..l.....kow
wwwwwwwwwwwwwwwww
