wwwwwwwwwwwwwwwww
w...............w
w...............w
w...............w
w..........g....w
wwwswwwwwwwwwwwww
w..s.m..........w
wi.s.s..l.....kow
wwwwwwwwwwwwwwwww
