wwwwwwwwwwwwwwwwwwwwwwwwwwwwwwwwwwwwwwwwwwwwwww
w....................................ws......ow
w....................................wsw......w
w..k...........ssss..................wsw.m....w
w..........m......s..................wswwwwwwww
w.c.wwwwwwwwwwww..s..................ws...m...w
w.................s..................wwwwswwwww
w...............ssssm....................s....w
w.................s.w....................s....w
w.................s.............c.c.sss..s....w
w.................s.....cc.c.c........s.......w
w..................wwww...............s.......w
w............s.s......................s.......w
w...g........s.s......................s.......w
w..ccc..c..s.s.s......................s.......w
w..........s...s......................s.......w
w..........s...s........m........m....s.......w
w..........s...ww.c.rrrrrrr.rrrrrrrrr.........w
w..........s..................................w
w..........s..................................w
w..........s.w.w.w.w..w.w.www.ww.www..........w
w...................................w.........w
wl..........m..m..m..m...t...t..t....w.......iw
wwwwwwwwwwwwwwwwwwwwwwwwwwwwwwwwwwwwwwwwwwwwwww
