wwwwwwwwwwwwwwwwwwwwwwwww
w....................k..w
w................wswwwwww
w.................s.....w
w.................s...m.w
w................wwwswwww
w...................s...w
wo........m.........s...w
wwwwwwwwwwsww.......s...w
w.........s.........s...w
w.........s.........s...w
w...wwwswwww..wwwwwwww..w
w......s................w
w......sm...............w
w.wwwwwwwwwwww.ww.wwwsw.w
wi...................s..w
wwwwwwwwwwwwwwwwwwwwwwwww
