wwwwwwwwwwwwwwwwwwwwwwwwwwwwwwwwwwwwwwwwwwwwwwwwwwwwwwwwwwwwwwwwwwwwwwww
w1222222222222222222222222222222222222222222222222222222222222222222223w
w4....................................................................5w
w4....................................................k...............5w
w4......................................................w.............5w
w4..............wwwwwm.....wwwwwwwwtwtwww...mm.........mw.............5w
w4.........s.w.ww..wwwwwwwwwwwwwwwwwwwwwwwwwwwwwwwwwwwwww............o5w
w4.........s....w................ss..ss..ss..ss..ss..ss..............s5w
w4.l.......s....wwwww................................................s5w
w4.w.w.w.wss........w.........sw..77..77..77..77..77..7777777777.w.w.s5w
w4..t.t.twwwwwsw..............s.....tt......tt......tt..........t.t.t.5w
w4..w.w.w.....s...............s.....ww......ww......ww..........w.w.w.5w
w4............s...............s.......................................5w
w4............s...............s.......................................5w
w4............s.......m.......s........m......m......................i5w
w6777777777777777777777777777777777777777777777777777777777777777777778w
wwwwwwwwwwwwwwwwwwwwwwwwwwwwwwwwwwwwwwwwwwwwwwwwwwwwwwwwwwwwwwwwwwwwwwww
